37 37 37 37 37 37 37 37 37 37 37 37 37 37 37 37 37 37 37 37 37 37 37 37 37 37 37 37 37 37 37 37 37 37 37 37 37 37 37 37 37 37 37 37 37 37 37 37 37 37
37 37 37 37 37 37 37 37 37 37 37 37 37 37 37 37 37 37 37 37 37 37 37 37 37 37 37 37 37 37 37 37 37 37 37 37 37 37 37 37 37 37 37 37 37 37 37 37 37 37
37 37 37 37 37 37 37 37 37 37 37 37 37 37 37 37 37 37 37 37 37 37 37 37 37 37 37 37 37 37 37 37 37 37 37 37 37 37 37 37 37 37 37 37 37 37 37 37 37 37
37 37 37 19 19 19 19 19 19 19 19 19 19 19 19 19 19 19 19 19 19 19 19 19 19 19 19 19 19 19 19 19 19 19 19 19 19 19 19 19 19 19 19 19 19 37 37 37 37 37
37 37 37 19 19 19 19 19 19 19 19 19 19 19 19 19 19 19 19 19 19 19 19 19 19 19 19 19 19 19 19 19 19 19 19 19 19 19 19 19 19 19 19 19 19 37 37 37 37 37
37 37 37 19 19 19 19 19 19 19 19 19 19 19 19 19 19 19 19 19 19 19 19 19 19 19 19 19 19 19 19 19 19 19 19 19 19 19 19 19 19 19 19 19 19 37 37 37 37 37
37 37 37 19 19 19 37 37 37 37 37 37 37 37 37 37 37 37 37 37 37 37 37 37 37 37 37 37 37 37 19 19 37 37 37 37 37 37 37 19 19 37 37 37 37 37 37 37 37 37
37 37 37 19 19 19 37 37 37 37 37 37 37 37 37 37 37 37 37 37 37 37 37 37 37 37 37 37 37 37 19 19 37 37 37 37 37 37 37 19 19 37 37 37 37 37 37 37 37 37
37 37 37 19 19 19 37 37 19 19 19 19 19 19 19 19 19 37 37 19 19 19 19 19 19 19 19 19 37 37 19 19 37 37 19 19 19 37 37 19 19 37 37 37 37 37 37 37 37 37
37 37 37 19 19 19 37 37 19 19 19 19 19 19 19 19 19 37 37 19 19 19 19 19 19 19 19 19 37 37 19 19 37 37 19 19 19 37 37 19 19 19 19 19 19 19 19 37 37 37
37 37 37 19 19 19 37 37 19 19 37 37 37 37 37 19 19 37 37 19 19 19 37 37 37 37 37 37 37 37 19 19 37 37 19 19 19 37 37 19 19 19 19 19 19 19 19 37 37 37
37 37 37 19 19 19 37 37 19 19 37 37 37 37 37 19 19 37 37 19 19 19 37 37 37 37 37 37 37 37 19 19 37 37 19 19 19 37 37 37 37 37 37 37 37 19 19 37 37 37
37 37 37 19 19 19 37 37 19 19 37 37 37 37 37 19 19 37 37 19 19 19 37 37 37 37 37 37 37 37 19 19 37 37 19 19 19 37 37 37 37 37 37 37 37 19 19 37 37 37
37 37 37 19 19 19 37 37 19 19 37 37 37 37 37 19 19 37 37 19 19 19 19 19 19 19 19 19 19 19 19 19 37 37 19 19 19 37 37 37 37 37 37 37 37 19 19 37 37 37
37 37 37 19 19 19 37 37 19 19 37 37 37 37 37 19 19 37 37 19 19 19 19 19 19 19 19 19 19 19 19 19 37 37 19 19 19 37 37 19 19 19 19 19 19 19 19 37 37 37
37 37 37 19 19 19 37 37 19 19 37 37 37 37 37 19 19 37 37 37 37 37 37 37 37 37 37 37 37 37 19 19 37 37 19 19 19 37 37 19 19 19 19 19 19 19 19 37 37 37
37 37 37 19 19 19 37 37 19 19 37 37 37 37 37 19 19 37 37 37 37 37 37 37 37 37 37 37 37 37 19 19 37 37 19 19 19 37 37 19 19 37 37 37 37 37 37 37 37 37
37 37 37 19 19 19 37 37 19 19 37 37 37 37 37 19 19 37 37 37 37 37 37 37 37 37 37 37 37 37 19 19 37 37 19 19 19 37 37 19 19 37 37 37 37 37 37 37 37 37
37 37 37 19 19 19 37 37 19 19 37 37 37 37 37 19 19 37 37 37 37 37 37 37 37 37 37 37 37 37 19 19 37 37 19 19 19 37 37 19 19 37 37 37 37 37 37 37 37 37
37 37 37 19 19 19 37 37 19 19 37 37 19 19 19 19 19 19 19 19 19 19 19 19 19 19 19 19 19 19 19 19 37 37 19 19 19 37 37 19 19 19 19 19 19 19 19 37 37 37
37 37 37 19 19 19 37 37 19 19 37 37 19 19 19 19 19 19 19 19 19 19 19 19 19 19 19 19 19 19 19 19 37 37 19 19 19 37 37 19 19 19 19 19 19 19 19 37 37 37
37 37 37 19 19 19 37 37 19 19 37 37 19 19 37 37 37 37 37 37 37 37 37 37 37 37 37 37 37 37 37 37 37 37 19 19 19 37 37 37 37 37 19 19 19 19 19 37 37 37
37 37 37 19 19 19 37 37 19 19 37 37 37 37 37 37 37 37 37 37 37 37 37 37 37 37 37 37 37 37 37 37 37 37 19 19 19 37 37 37 37 37 19 19 19 19 19 37 37 37
37 37 37 19 19 19 37 19 19 19 19 19 19 19 19 19 37 37 19 19 19 19 19 19 19 19 19 19 19 19 19 19 19 19 19 19 19 19 19 19 19 19 19 19 19 19 19 37 37 37
37 37 37 19 19 19 37 19 19 19 19 19 19 19 19 19 37 37 19 19 19 19 19 19 19 19 19 19 19 19 19 19 19 19 19 19 19 19 19 19 19 19 19 19 19 19 37 37 37 37
37 37 37 19 19 19 37 19 19 19 19 19 19 19 19 19 37 37 19 19 41 19 19 19 19 19 19 19 19 19 19 19 19 19 19 19 19 19 19 19 19 19 19 19 19 19 37 37 37 37
37 37 37 19 19 19 37 19 19 19 19 19 19 19 19 19 37 37 19 19 19 19 19 19 19 19 19 19 19 19 19 19 19 19 19 19 19 19 19 19 19 19 19 19 19 19 37 37 37 37
37 37 37 19 19 19 37 19 19 19 19 19 19 19 19 19 37 37 19 19 19 19 19 19 19 19 19 19 19 19 19 19 19 19 19 19 19 19 19 19 19 19 19 19 19 19 19 37 37 37
37 37 37 19 19 19 37 19 19 19 19 19 19 19 19 19 37 37 37 37 37 37 37 37 37 37 37 37 37 37 37 37 37 37 19 19 19 37 37 37 37 37 37 37 19 19 19 37 37 37
37 37 37 37 37 37 37 37 37 37 37 37 37 37 37 37 37 37 37 37 37 37 37 37 37 37 37 37 37 37 37 37 37 37 19 19 19 37 37 37 37 37 37 37 19 19 19 37 37 37
37 37 37 37 37 37 37 37 37 37 37 37 37 37 37 37 37 37 37 37 37 37 37 37 37 37 37 37 37 37 37 37 37 37 19 19 19 37 37 19 19 37 37 37 19 19 19 37 37 37
37 37 37 19 19 19 37 37 37 37 37 37 37 37 37 37 37 37 37 37 37 37 37 37 37 37 37 37 37 37 37 37 37 37 19 19 19 37 37 19 19 37 37 37 19 19 19 37 37 37
37 37 37 19 19 19 37 37 37 37 37 37 37 37 37 37 37 37 37 37 37 37 37 37 37 37 37 37 37 37 37 37 37 37 19 19 19 37 37 19 19 37 37 37 19 19 19 37 37 37
37 37 37 19 19 19 37 37 37 37 37 37 37 37 37 37 37 37 37 37 37 37 37 37 37 37 37 37 37 37 37 37 37 37 19 19 19 37 37 19 19 37 37 37 19 19 19 37 37 37
37 37 37 19 19 19 19 19 19 19 19 19 19 19 19 19 19 19 19 19 19 19 19 19 19 19 19 19 19 19 19 19 19 19 19 19 19 37 37 19 19 37 37 37 19 19 19 37 37 37
37 37 37 19 19 19 19 19 19 19 19 19 19 19 19 19 19 19 19 19 19 19 19 19 19 19 19 19 19 19 19 19 19 19 19 19 19 37 37 19 19 37 37 37 19 19 19 37 37 37
37 37 37 19 19 19 19 19 19 19 19 19 19 19 19 19 19 19 19 19 19 19 19 19 19 19 19 19 19 19 19 19 19 19 19 19 19 37 37 19 19 37 37 37 19 19 19 37 37 37
37 37 37 37 37 37 37 37 19 19 37 37 37 37 37 37 37 37 37 37 37 37 37 19 19 19 37 37 37 37 37 37 37 37 37 37 37 37 37 19 19 37 37 37 19 19 19 37 37 37
37 37 37 37 37 37 37 37 19 19 37 37 37 37 37 37 37 37 37 37 37 37 37 19 19 19 37 37 37 37 37 37 37 37 37 37 37 37 37 19 19 19 19 19 19 19 19 37 37 37
37 37 37 19 19 37 37 37 19 19 37 37 19 19 19 19 19 19 19 19 19 37 37 19 19 19 37 37 19 19 19 19 19 19 19 19 19 19 19 19 19 19 19 19 19 19 19 37 37 37
37 37 37 19 19 37 37 37 19 19 37 37 19 19 19 19 19 19 19 19 19 37 37 19 19 19 37 37 19 19 19 19 19 19 19 19 19 19 19 19 19 19 19 19 19 19 19 37 37 37
37 37 37 19 19 37 37 37 19 19 37 37 19 19 19 37 37 37 37 37 37 37 37 19 19 19 37 37 37 37 37 37 37 37 37 37 19 19 19 37 37 37 37 37 19 19 19 37 37 37
37 37 37 19 19 19 19 19 19 19 37 37 19 19 19 37 37 37 37 37 37 37 37 19 19 19 37 37 37 37 37 37 37 37 37 37 19 19 19 37 37 37 37 37 19 19 19 37 37 37
37 37 37 19 19 19 19 19 19 19 37 37 19 19 19 19 19 19 19 19 19 19 19 19 19 19 19 19 19 19 19 19 19 19 19 19 19 19 19 37 37 37 37 37 19 19 19 37 37 37
37 37 37 19 19 37 37 37 19 19 37 37 19 19 19 19 19 19 19 19 19 19 19 19 19 19 19 19 19 19 19 19 19 19 19 19 19 19 19 37 37 37 37 37 19 19 19 37 37 37
37 37 37 19 19 37 37 37 19 19 37 37 19 19 19 19 19 19 19 19 19 19 19 19 19 19 19 19 19 19 19 19 19 19 19 19 19 19 19 37 37 37 37 37 19 19 19 37 37 37
37 37 37 19 19 37 37 37 19 19 37 37 37 37 37 37 37 37 37 37 37 37 37 19 19 19 37 37 37 37 37 37 37 37 37 37 37 37 37 37 37 37 37 37 37 37 37 37 37 37
37 37 37 37 37 37 37 37 37 37 37 37 37 37 37 37 37 37 37 37 37 37 37 19 19 19 37 37 37 37 37 37 37 37 37 37 37 37 37 37 37 37 37 37 37 37 37 37 37 37
37 37 37 37 37 37 37 37 37 37 37 37 37 37 37 37 37 37 37 37 37 37 37 37 37 37 37 37 37 37 37 37 37 37 37 37 37 37 37 37 37 37 37 37 37 37 37 37 37 37
37 37 37 37 37 37 37 37 37 37 37 37 37 37 37 37 37 37 37 37 37 37 37 37 37 37 37 37 37 37 37 37 37 37 37 37 37 37 37 37 37 37 37 37 37 37 37 37 37 37