21 21 21 22 21 21 21 21 21 21 21 21 21 21 21 21 21 21 21 21 21 21 21 21 21 21 21 21 21 21 21 21 21 21 21 21 21 21 21 21 21 21 21 21 21 21 21 21 21 22
21 21 21 21 21 21 22 21 21 21 21 21 21 21 21 22 21 21 21 21 21 21 21 21 21 22 21 21 21 21 21 21 21 21 21 21 21 21 21 21 21 21 21 21 21 21 21 21 21 21
22 21 21 21 21 21 21 21 21 21 21 22 21 21 21 21 21 21 21 21 21 21 21 21 21 21 21 21 21 21 21 21 21 21 21 21 21 22 21 21 22 21 21 21 22 21 21 21 21 21
21 21 21 21 21 21 21 21 21 21 21 21 21 21 21 21 21 21 21 22 21 21 21 21 21 21 21 21 21 21 21 21 21 21 21 21 21 21 21 21 21 21 21 21 21 21 21 22 21 21
21 21 21 21 21 21 21 21 21 21 21 21 21 21 21 21 21 21 21 21 21 21 21 21 21 21 21 21 22 21 21 21 21 21 22 21 21 21 21 21 21 21 21 21 21 21 21 21 21 21
21 21 21 21 21 21 21 21 21 21 21 21 21 21 22 21 21 21 21 21 22 21 21 21 21 21 22 21 21 21 21 22 21 21 21 21 21 21 21 21 21 21 22 21 21 21 21 21 21 21
21 21 21 21 21 21 21 21 21 21 21 21 21 21 21 21 21 32 30 30 30 30 30 30 33 21 21 32 30 30 30 30 30 30 30 30 30 30 33 21 21 21 21 21 21 21 21 21 21 21
21 21 21 21 21 21 22 21 21 21 21 21 22 21 21 21 32 31 2 1 1 1 1 2 29 33 32 31 14 11 11 11 11 11 11 11 15 1 29 33 21 21 21 21 21 21 22 21 21 21
21 21 22 21 21 21 21 21 21 22 21 32 30 30 30 30 31 1 1 1 18 18 1 1 39 39 39 39 9 3 3 3 3 3 3 3 8 18 1 26 21 22 21 21 21 21 21 21 21 21
21 21 21 21 22 21 21 32 30 30 30 31 1 18 2 1 1 18 18 18 18 18 14 11 15 26 35 25 16 5 5 5 5 5 7 3 8 1 18 29 33 21 21 21 21 21 21 21 22 21
21 21 21 21 21 21 32 31 14 11 11 11 11 11 11 11 11 11 15 18 18 1 9 3 8 26 21 35 25 2 18 18 1 2 9 3 8 2 1 18 26 21 21 21 21 21 21 21 21 21
21 21 21 21 21 32 31 1 9 3 3 3 3 3 3 3 3 3 8 1 2 18 9 3 8 29 33 22 35 25 18 18 18 18 9 3 8 18 38 1 26 21 22 21 21 21 21 21 21 21
22 21 21 21 21 28 1 2 9 3 4 5 5 5 5 5 7 3 8 18 1 1 9 3 8 18 26 21 21 28 1 2 1 1 9 3 8 1 2 18 26 21 21 21 21 21 21 22 21 21
21 21 21 21 21 28 1 18 9 3 8 18 18 2 1 18 9 3 10 11 11 11 12 3 8 1 29 33 22 28 1 18 1 2 9 3 8 18 1 1 29 33 21 21 21 21 21 21 21 21
21 21 21 21 21 28 18 2 9 3 8 2 1 1 18 1 9 3 3 3 3 3 3 3 8 1 2 29 33 35 25 1 1 18 16 5 17 2 1 1 2 26 21 21 21 21 21 21 21 21
21 21 21 22 21 28 1 18 9 3 8 1 18 18 1 1 16 5 5 5 5 5 7 3 8 2 1 1 29 33 35 24 24 24 25 39 1 1 1 18 1 26 21 21 21 21 21 21 21 21
21 21 21 21 21 28 1 18 9 3 10 11 15 1 1 1 2 18 18 1 1 2 9 3 8 18 1 1 1 26 21 21 22 21 35 39 24 25 1 38 1 26 21 21 21 21 21 21 21 21
21 21 22 21 21 35 25 1 9 3 3 3 8 2 18 18 1 18 1 18 18 1 9 3 8 1 2 1 18 29 30 30 33 21 32 39 33 28 1 1 1 26 21 21 22 21 21 21 21 21
21 21 21 21 21 21 28 1 16 5 7 3 8 18 1 1 1 18 2 1 18 18 9 3 8 1 18 1 1 1 2 1 29 30 31 39 26 35 24 24 24 36 21 21 21 21 21 21 22 21
21 22 21 21 21 22 35 25 1 2 9 3 8 2 18 37 37 37 37 37 1 18 9 3 8 1 1 1 18 1 1 18 1 1 18 1 29 30 30 33 21 21 21 22 21 21 21 21 21 21
21 21 21 21 21 21 21 28 1 18 9 3 8 1 18 37 19 19 19 37 18 18 9 3 8 18 2 1 18 2 1 18 1 1 14 11 15 1 18 29 30 30 33 21 21 21 21 21 21 21
21 21 21 21 21 21 21 28 18 1 9 3 10 15 37 37 19 19 19 37 1 18 9 3 10 11 15 1 1 18 1 2 1 18 9 3 8 2 18 18 1 1 29 30 33 21 22 32 30 30
21 22 21 21 21 21 22 28 2 1 9 3 3 8 19 19 19 6 19 37 2 18 9 3 3 3 8 18 2 1 18 1 1 1 9 3 8 18 18 2 1 1 1 1 29 30 30 31 1 2
21 21 21 21 21 21 21 28 1 1 9 3 4 17 37 37 19 19 19 37 18 18 16 5 7 3 10 11 11 11 11 11 11 11 12 3 10 11 15 1 2 18 18 1 2 1 1 18 18 1
21 21 21 21 21 21 21 28 1 18 9 3 8 18 1 37 19 19 19 37 1 1 1 1 9 3 3 3 3 3 3 3 3 3 3 3 3 3 8 18 18 18 18 18 1 18 18 18 1 1
21 21 21 22 21 22 21 28 1 2 9 3 8 1 18 37 37 37 37 37 1 2 1 18 9 3 4 5 5 5 5 5 5 5 5 5 7 3 8 18 2 1 2 18 18 18 1 1 2 18
21 21 21 22 21 21 21 28 18 1 9 3 8 18 1 2 18 1 1 18 18 1 1 18 9 3 8 18 1 1 18 2 1 2 1 18 9 3 8 18 1 2 18 18 18 18 18 18 18 18
21 21 21 21 21 32 30 31 18 18 9 3 8 18 18 1 18 18 2 1 18 1 18 1 9 3 8 1 23 25 2 1 23 24 25 1 9 3 8 18 18 18 18 1 1 1 1 2 18 18
21 21 21 21 21 28 2 1 1 2 9 3 10 11 11 11 15 1 1 1 18 18 1 18 9 3 8 1 26 35 24 24 36 22 28 2 9 3 8 2 1 18 1 2 38 1 18 1 18 18
21 21 21 21 21 28 1 2 18 1 9 3 3 3 3 3 8 18 18 18 18 1 1 18 9 3 8 18 26 22 21 21 32 30 31 18 9 3 8 18 1 1 18 1 2 18 14 11 11 11
21 21 21 21 21 28 1 1 1 1 16 5 5 5 7 3 8 2 1 1 2 1 18 1 9 3 8 18 29 33 21 32 31 1 18 1 9 3 10 11 11 11 11 11 11 11 12 3 3 3
22 21 21 21 21 35 24 24 24 24 25 2 1 1 9 3 8 1 18 1 1 1 18 1 9 3 8 2 1 29 30 31 18 18 1 2 9 3 3 3 3 3 3 3 3 3 3 3 4 5
22 22 21 21 21 32 30 30 30 33 35 24 25 18 9 3 8 2 1 18 1 18 1 2 9 3 8 1 18 2 2 1 2 14 11 11 12 3 4 5 5 5 5 5 5 5 5 5 17 18
21 21 21 21 21 28 2 1 18 29 33 22 35 25 9 3 10 11 11 11 11 11 11 11 12 3 10 11 11 11 11 11 11 12 3 3 3 3 8 2 1 18 1 2 18 1 2 18 18 18
21 21 21 21 21 28 1 2 1 1 26 21 22 28 9 3 3 3 3 3 3 3 3 3 3 3 3 3 3 3 3 3 3 3 3 4 5 5 17 18 1 18 18 1 1 1 1 1 18 18
21 22 21 21 21 35 25 1 38 1 29 30 33 28 16 5 5 5 7 3 4 5 5 5 5 5 5 5 5 7 3 4 5 5 5 17 2 1 1 1 18 1 2 1 18 1 23 24 24 24
21 21 21 21 21 21 35 25 1 18 2 1 26 28 2 18 1 2 9 3 8 1 18 1 2 1 18 1 38 9 3 8 2 1 18 1 1 18 1 23 24 24 24 24 24 24 36 22 21 21
21 21 21 21 21 21 21 35 25 1 1 1 26 28 1 1 18 1 9 3 8 2 38 1 18 18 1 1 2 9 3 8 18 1 1 2 18 1 23 36 21 21 21 21 21 21 21 21 22 21
21 21 21 21 21 21 21 21 35 24 25 2 26 35 25 1 1 1 9 3 8 18 1 2 1 38 18 2 18 16 5 17 1 1 1 1 23 24 36 21 21 22 21 21 21 21 22 21 21 21
21 21 21 21 21 21 21 21 21 21 35 24 36 21 35 25 1 2 16 5 17 1 1 1 18 1 1 1 1 1 1 2 23 24 24 24 36 21 21 22 21 21 21 21 21 21 21 21 21 21
21 21 21 21 21 21 21 21 21 21 21 21 21 21 21 35 24 24 24 24 24 24 24 24 24 24 24 24 24 24 24 24 36 21 21 21 21 21 21 21 21 21 21 22 21 21 21 21 21 21
21 21 21 22 21 21 22 21 21 21 21 21 21 21 21 21 21 21 21 21 21 21 21 21 21 21 21 21 21 21 21 21 21 22 21 21 21 21 21 21 21 21 21 21 21 21 21 21 21 21
21 21 21 21 21 21 21 21 21 21 21 21 21 21 21 21 21 21 21 22 21 21 21 21 21 22 21 21 21 21 21 22 21 21 21 21 21 21 32 30 30 33 21 21 21 21 21 21 21 21
21 21 21 21 21 21 21 21 21 21 21 21 22 21 21 21 21 21 21 21 21 21 21 21 21 32 30 30 30 33 21 21 21 21 21 21 32 30 31 1 2 29 33 21 21 21 21 22 21 21
21 21 21 21 21 21 21 21 21 21 22 21 21 21 21 21 21 22 21 21 21 21 21 21 21 28 1 1 2 26 21 21 22 21 21 32 31 1 1 1 1 1 26 21 21 21 21 21 21 21
21 21 21 21 21 21 22 21 21 21 21 21 21 21 21 21 21 21 21 21 21 21 21 21 32 31 1 1 1 26 21 21 21 21 21 28 1 2 1 1 1 1 26 21 21 21 21 21 21 21
21 21 21 21 21 21 21 21 21 21 21 21 21 21 21 21 21 21 21 21 21 21 21 21 28 1 2 1 23 36 21 21 21 21 21 35 25 1 1 23 24 24 36 21 21 21 21 21 21 21
21 21 21 21 21 21 21 21 21 21 21 21 21 21 21 21 21 22 21 22 21 21 21 21 35 25 1 1 26 21 21 21 21 21 21 21 35 24 24 36 21 21 21 21 21 21 21 21 21 21
21 21 22 21 21 21 21 21 21 21 21 21 21 21 21 22 21 21 21 21 21 21 21 21 21 35 24 24 36 21 22 21 21 21 21 22 21 21 21 21 21 21 21 21 22 21 21 21 22 21
21 21 21 21 21 21 21 21 21 21 21 21 21 21 21 21 21 21 21 21 21 21 21 21 21 21 21 21 21 21 21 21 21 21 21 21 21 21 21 21 21 21 21 21 21 21 21 21 21 21